{
  "width": 32,
  "height": 32,
  "tile-set": "city",
  "objects-floor": [

  ],
  "objects-main": [
    {
      "template": "main-gate",
      "name": "main-gate",
      "x": 12.0,
      "y": 15.0
    },
    {
      "template": "wall",
      "x": 0.0,
      "y": 15.0
    },
    {
      "template": "wall",
      "x": 4.0,
      "y": 15.0
    },
    {
      "template": "wall",
      "x": 8.0,
      "y": 15.0
    },
    {
      "template": "wall",
      "x": 20.0,
      "y": 15.0
    },
    {
      "template": "wall",
      "x": 24.0,
      "y": 15.0
    },
    {
      "template": "wall",
      "x": 28.0,
      "y": 15.0
    },
    {
      "template": "main-gate-door",
      "x": 11.0,
      "y": 18.0
    },
    {
      "template": "spawn-point",
      "x": 16.0,
      "y": 29.875,
      "move-direction": "UP_RIGHT",
      "scripts": {
        "on-tile-entered-client": "gate-door"
      }
    }
  ],
  "objects-roof": [

  ],
  "tiles": [
    4,4,6,6,4,4,4,4,4,4,4,4,7,7,7,7,7,7,7,7,4,4,4,4,6,6,4,4,4,4,4,4,
    4,4,4,4,4,4,4,4,6,6,4,4,7,7,7,7,7,7,7,7,6,4,6,4,6,6,4,6,6,4,4,4,
    4,6,4,4,4,6,6,4,4,4,4,4,7,7,7,7,7,7,7,7,4,6,6,4,6,4,4,4,6,6,4,4,
    4,4,6,6,6,6,4,4,6,4,4,4,7,7,7,7,7,7,7,7,4,4,4,4,4,4,4,4,4,4,4,4,
    4,4,6,4,4,4,4,4,4,4,4,4,7,7,7,7,7,7,7,7,4,4,4,4,4,4,4,4,4,6,4,4,
    4,4,4,6,4,4,4,4,4,4,4,4,7,7,7,7,7,7,7,7,6,4,4,6,4,6,6,4,6,6,4,4,
    4,4,4,6,6,4,4,4,6,4,4,4,7,7,7,7,7,7,7,7,4,4,4,6,6,6,6,4,4,4,4,4,
    4,6,4,4,4,4,6,6,6,6,4,4,7,7,7,7,7,7,7,7,4,4,4,4,4,4,4,4,4,4,4,4,
    4,6,6,4,4,4,4,4,4,4,6,4,7,7,7,7,7,7,7,7,4,4,4,4,4,4,4,6,4,6,6,4,
    4,4,4,4,4,4,4,4,4,4,6,4,7,7,7,7,7,7,7,7,6,6,4,4,4,4,4,4,4,6,4,4,
    4,6,4,4,6,6,4,4,6,6,6,4,7,7,7,7,7,7,7,7,6,6,4,4,6,4,4,4,4,6,4,4,
    4,6,4,4,4,4,4,4,6,4,4,4,7,7,7,7,7,7,7,7,4,4,6,4,6,4,4,4,4,4,4,4,
    4,4,4,4,6,4,4,4,6,4,4,4,7,7,7,7,7,7,7,7,4,6,6,6,4,4,4,6,6,4,4,4,
    4,4,4,4,4,4,6,4,4,4,4,4,7,7,7,7,7,7,7,7,4,4,4,4,6,4,4,6,4,4,4,4,
    4,4,4,4,4,4,4,4,4,4,6,4,7,7,7,7,7,7,7,7,4,4,4,6,4,4,4,6,4,4,4,4,
    7,7,7,7,7,7,7,7,7,7,7,7,7,7,7,7,7,7,7,7,7,7,7,7,7,7,7,7,7,7,7,7,
    7,7,7,7,7,7,7,7,7,7,7,7,7,7,7,7,7,7,7,7,7,7,7,7,7,7,7,7,7,7,7,7,
    7,7,7,7,7,7,7,7,7,7,7,7,7,7,7,7,7,7,7,7,7,7,7,7,7,7,7,7,7,7,7,7,
    4,4,4,4,4,4,4,4,4,4,4,4,7,7,7,7,7,7,7,7,6,6,6,4,6,6,4,4,4,4,4,4,
    6,6,4,4,6,4,4,4,6,6,4,4,7,7,7,7,7,7,7,7,4,4,6,6,6,4,6,4,4,4,4,4,
    4,6,6,4,4,4,4,6,6,6,4,4,4,7,7,7,7,7,7,6,4,9,9,4,4,6,4,6,6,6,4,4,
    4,6,6,4,4,6,4,4,4,4,4,4,4,4,7,7,7,7,4,6,6,9,9,4,6,6,6,6,6,4,4,4,
    4,6,4,4,4,4,6,4,4,6,4,6,4,4,7,7,7,7,6,4,6,9,9,4,6,6,4,4,6,4,4,4,
    4,6,4,4,4,4,6,4,6,4,4,4,4,4,7,7,7,7,4,4,6,9,9,4,6,6,6,4,4,4,4,6,
    4,4,4,6,4,4,4,4,4,4,4,4,6,4,7,7,7,7,4,6,4,9,4,4,6,6,6,6,4,4,6,4,
    4,4,4,4,6,4,4,4,4,4,6,4,4,4,7,7,7,7,4,4,4,9,4,4,6,6,6,6,6,4,6,4,
    4,4,6,4,4,4,4,6,4,4,4,4,4,4,7,7,7,7,9,4,4,9,4,4,6,6,4,6,6,4,6,4,
    6,4,4,4,4,6,4,4,4,4,4,4,4,4,7,7,7,7,9,9,9,9,4,6,6,6,6,6,4,6,6,4,
    6,4,4,4,4,4,4,4,4,4,6,4,6,4,7,7,7,7,6,6,4,4,4,6,4,4,6,6,4,4,4,4,
    4,4,6,4,4,4,4,6,4,4,6,4,4,4,7,7,7,7,6,6,6,6,6,4,6,6,6,6,4,4,4,4,
    4,4,6,4,4,4,6,6,4,4,4,4,4,4,7,7,7,7,6,6,4,6,6,4,4,6,6,6,4,4,4,4,
    4,4,4,4,4,4,4,4,4,4,4,4,4,4,7,7,7,7,4,4,4,4,4,4,4,4,4,4,4,4,4,4
  ],
  "walkability": [
    1,1,1,1,1,1,1,1,1,1,1,1,1,1,1,1,1,1,1,1,1,1,1,1,1,1,1,1,1,1,1,1,
    1,1,1,1,1,1,1,1,1,1,1,1,1,1,1,1,1,1,1,1,1,1,1,1,1,1,1,1,1,1,1,1,
    1,1,1,1,1,1,1,1,1,1,1,1,1,1,1,1,1,1,1,1,1,1,1,1,1,1,1,1,1,1,1,1,
    1,1,1,1,1,1,1,1,1,1,1,1,1,1,1,1,1,1,1,1,1,1,1,1,1,1,1,1,1,1,1,1,
    1,1,1,1,1,1,1,1,1,1,1,1,1,1,1,1,1,1,1,1,1,1,1,1,1,1,1,1,1,1,1,1,
    1,1,1,1,1,1,1,1,1,1,1,1,1,1,1,1,1,1,1,1,1,1,1,1,1,1,1,1,1,1,1,1,
    1,1,1,1,1,1,1,1,1,1,1,1,1,1,1,1,1,1,1,1,1,1,1,1,1,1,1,1,1,1,1,1,
    1,1,1,1,1,1,1,1,1,1,1,1,1,1,1,1,1,1,1,1,1,1,1,1,1,1,1,1,1,1,1,1,
    1,1,1,1,1,1,1,1,1,1,1,1,1,1,1,1,1,1,1,1,1,1,1,1,1,1,1,1,1,1,1,1,
    1,1,1,1,1,1,1,1,1,1,1,1,1,1,1,1,1,1,1,1,1,1,1,1,1,1,1,1,1,1,1,1,
    1,1,1,1,1,1,1,1,1,1,1,1,1,1,1,1,1,1,1,1,1,1,1,1,1,1,1,1,1,1,1,1,
    1,1,1,1,1,1,1,1,1,1,1,1,1,1,1,1,1,1,1,1,1,1,1,1,1,1,1,1,1,1,1,1,
    1,1,1,1,1,1,1,1,1,1,1,1,1,1,1,1,1,1,1,1,1,1,1,1,1,1,1,1,1,1,1,1,
    1,1,1,1,1,1,1,1,1,1,1,1,1,1,1,1,1,1,1,1,1,1,1,1,1,1,1,1,1,1,1,1,
    1,1,1,1,1,1,1,1,1,1,1,1,1,1,1,1,1,1,1,1,1,1,1,1,1,1,1,1,1,1,1,1,
    3,3,3,3,3,3,3,3,3,3,3,3,1,1,1,1,1,1,1,1,3,3,3,3,3,3,3,3,3,3,3,3,
    3,3,3,3,3,3,3,3,3,3,3,3,1,1,1,1,1,1,1,1,3,3,3,3,3,3,3,3,3,3,3,3,
    3,3,3,3,3,3,3,3,3,3,3,3,1,1,1,1,1,1,1,1,3,3,3,3,3,3,3,3,3,3,3,3,
    1,1,1,1,1,1,1,1,1,1,1,1,1,1,1,1,1,1,1,1,1,1,1,1,1,1,1,1,1,1,1,1,
    1,1,1,1,1,1,1,1,1,1,1,1,1,1,1,1,1,1,1,1,1,1,1,1,1,1,1,1,1,1,1,1,
    1,1,1,1,1,1,1,1,1,1,1,1,1,1,1,1,1,1,1,1,1,1,1,1,1,1,1,1,1,1,1,1,
    1,1,1,1,1,1,1,1,1,1,1,1,1,1,1,1,1,1,1,1,1,1,1,1,1,1,1,1,1,1,1,1,
    1,1,1,1,1,1,1,1,1,1,1,1,1,1,1,1,1,1,1,1,1,1,1,1,1,1,1,1,1,1,1,1,
    1,1,1,1,1,1,1,1,1,1,1,1,1,1,1,1,1,1,1,1,1,1,1,1,1,1,1,1,1,1,1,1,
    1,1,1,1,1,1,1,1,1,1,1,1,1,1,1,1,1,1,1,1,1,1,1,1,1,1,1,1,1,1,1,1,
    1,1,1,1,1,1,1,1,1,1,1,1,1,1,1,1,1,1,1,1,1,1,1,1,1,1,1,1,1,1,1,1,
    1,1,1,1,1,1,1,1,1,1,1,1,1,1,1,1,1,1,1,1,1,1,1,1,1,1,1,1,1,1,1,1,
    1,1,1,1,1,1,1,1,1,1,1,1,1,1,1,1,1,1,1,1,1,1,1,1,1,1,1,1,1,1,1,1,
    1,1,1,1,1,1,1,1,1,1,1,1,1,1,1,1,1,1,1,1,1,1,1,1,1,1,1,1,1,1,1,1,
    1,1,1,1,1,1,1,1,1,1,1,1,1,1,1,1,1,1,1,1,1,1,1,1,1,1,1,1,1,1,1,1,
    1,1,1,1,1,1,1,1,1,1,1,1,1,1,1,1,1,1,1,1,1,1,1,1,1,1,1,1,1,1,1,1,
    1,1,1,1,1,1,1,1,1,1,1,1,1,1,1,1,1,1,1,1,1,1,1,1,1,1,1,1,1,1,1,1
  ]
}